border_size=1
usage=map

Mm^Xm       , Mm^Xm       , Mm^Xm       , Mm^Xm       , Mm^Xm       , Mm^Xm       , Mm^Xm       , Mm^Xm       , Mm^Xm       , Mm^Xm       , Mm^Xm       , Mm^Xm       , Mm^Xm       , Mm^Xm       , Mm^Xm       , Mm^Xm       , Mm^Xm       , Mm^Xm       , Mm^Xm       , Mm^Xm       , Mm^Xm       , Mm^Xm       , Mm^Xm       , Mm^Xm       , Mm^Xm       , Mm^Xm       , Mm^Xm       , Mm^Xm       , Mm^Xm       , Mm^Xm       , Mm^Xm       , Mm^Xm       , Ms          , Ms          , Ms          , Ms          , Ms          , Ms          , Ms          , Ms          , Ms          , Ms          
Mm^Xm       , Mm^Xm       , Mm^Xm       , Mm^Xm       , Mm^Xm       , Mm^Xm       , Mm^Xm       , Mm^Xm       , Mm^Xm       , Mm^Xm       , Mm^Xm       , Mm^Xm       , Mm          , Mm^Xm       , Mm^Xm       , Mm^Xm       , Mm^Xm       , Mm^Xm       , Mm^Xm       , Mm^Xm       , Mm^Xm       , Mm^Xm       , Mm^Xm       , Mm^Xm       , Mm^Xm       , Mm^Xm       , Mm^Xm       , Mm^Xm       , Mm^Xm       , Mm^Xm       , Mm^Xm       , Mm^Xm       , Mm^Xm       , Ms          , Ms          , Ms          , Mm          , Ms          , Ms          , Ms          , Ms          , Ms          
Mm^Xm       , Mm^Xm       , Mm^Xm       , Mm^Xm       , Ms          , Mm^Xm       , Mm^Xm       , Mm^Xm       , Mm^Xm       , Mm^Xm       , Mm          , Mm          , Mm          , Mm          , Mm          , Mm^Xm       , Mm^Xm       , Mm^Xm       , Mm^Xm       , Mm^Xm       , Mm^Xm       , Mm^Xm       , Mm^Xm       , Mm^Xm       , Mm^Xm       , Mm^Xm       , Chr         , Mm^Xm       , Chr         , Mm^Xm       , Chr         , Mm^Xm       , Mm          , Mm          , Mm          , Mm          , Mm          , Mm          , Mm          , Ms          , Ms          , Ms          
Ms          , Ms          , Ms          , Ms          , Ha          , Ha          , Mm^Xm       , Mm^Xm       , Mm^Xm       , Mm^Xm       , Mm          , Mm          , Mm          , Mm          , Mm          , Mm^Xm       , Chr         , Mm^Xm       , Chr         , Mm^Xm       , Chr         , Chr         , Chr         , Chr         , Chr         , Chr         , Chr         , Chr         , Chr         , Chr         , Chr         , Chr         , Chr         , Mm          , Mm          , Mm          , Mm          , Mm          , Mm          , Ms          , Ms          , Ms          
Ms          , Ms          , Ms          , Ha          , Ha          , Ha          , Mm^Xm       , Mm^Xm       , Mm^Xm       , Mm          , Mm          , Mm          , Mm          , Mm          , Chr         , Chr         , Chr         , Chr         , Chr         , Chr         , Chr         , Chr         , Chr         , Chr         , Chr         , Chr         , Chr         , Chr         , Chr         , Chr         , Chr         , Chr         , Chr         , Chr         , Chr         , Mm          , Mm          , Mm          , Mm          , Mm          , Ms          , Ms          
Ms          , Ms          , Ms          , Ha          , Ha          , Ha          , Mm^Xm       , Mm^Xm       , Mm          , Mm          , Chr         , Chr         , Chr         , Chr         , Chr         , Chr         , Chr         , Chr         , Chr         , Chr         , Chr         , Chr         , Chr         , Chr         , Rr          , Rr          , Rr          , Chr         , Rr          , Chr         , Rr          , Chr         , Chr         , Chr         , Chr         , Mm          , Mm          , Mm          , Mm          , Mm          , Mm          , Ms          
Ms          , Ms          , Ms          , Ms          , Ha          , Ha          , Mm^Xm       , Mm^Xm       , Mm          , Mm          , Chr         , Chr         , Chr         , Chr         , Chr         , Chr         , Chr         , Chr         , Rr          , Chr         , Rr          , Rr          , Rr          , Rr          , Rr          , Rr          , Rr          , Rr          , Rr          , Rr          , Rr          , Rr          , Rr          , Chr         , Chr         , Chr         , Chr         , Mm          , Mm          , Mm          , Ms          , Ms          
Ms          , Ms          , Ms          , Ms          , Ha          , Ha          , Mm^Xm       , Mm^Xm       , Mm          , Mm          , Chr         , Chr         , Rr          , Chr         , Rr          , Rr          , Rr          , Rr          , Rr          , Rr          , Chr         , Chr         , Chr         , Rr          , Rr          , Rr          , Rr          , Rr          , Rr          , Rr          , Rr          , Rr          , Rr          , Rr          , Chr         , Chr         , Chr         , Ha          , Ha          , Ha          , Ms          , Ms          
Ms          , Ms          , Ha          , Ha          , Ha          , Ha          , Mm^Xm       , Mm^Xm       , Mm          , Chr         , Chr         , Chr         , Rr          , Rr          , Rr          , Rr          , Rr          , Rr          , Rr          , Rr          , Chr         , Chr         , Chr         , Rr          , Rr          , Rr          , Rr          , Rr          , Rr          , Rr          , Rr          , Rr          , Rr          , Rr          , Chr         , Chr         , Chr         , Ha          , Ha          , Ha          , Ms          , Ms          
Ms          , Ms          , Ms          , Ha          , Ha          , Ha^Fpa      , Ha^Fpa      , Mm^Xm       , Mm          , Chr         , Chr         , Chr         , Chr         , Rr          , Rr          , Rr          , Rr          , Rr          , Rr          , Rr          , Rr          , Chr         , Rr          , Rr          , Rr          , Rr          , Chr         , Rr          , Rr          , Rr          , Rr          , Rr          , Rr          , Rr          , Chr         , Chr         , Chr         , Ha          , Ha          , Ha          , Ms          , Ms          
Ms          , Ms          , Ms          , Ha          , Ha          , Ha^Fpa      , Ha^Fpa      , Ha^Fpa      , Ha^Fpa      , Chr         , Chr         , Chr         , Chr         , Chr         , Chr         , Chr         , Chr         , Rr          , Chr         , Rr          , Chr         , Rr          , Chr         , Rr          , Rr          , Chr         , 2 Khr       , Chr         , Re^Vct      , Rr          , Rr          , Rr          , Rr          , Rr          , Chr         , Chr         , Chr         , Ha          , Ha          , Ha          , Ms          , Ms          
Ms          , Ms          , Ms          , Ms          , Ms          , Ha          , Ha^Fpa      , Ha^Fpa      , Ha^Fpa      , Ha          , Ha          , Chr         , Chr         , Chr         , Chr         , Chr         , Chr         , Chr         , Chr         , Chr         , Chr         , Chr         , Chr         , Chr         , Rr          , Chr         , Chr         , Chr         , Rr          , Rr          , Rr          , Rr          , Chr         , Chr         , Chr         , Chr         , Chr         , Ha          , Ha          , Ha          , Ms          , Ms          
Ms          , Ha          , Ms          , Ms          , Ms          , Ha^Fpa      , Ha          , Ha^Fpa      , Ha          , Ha          , Ha          , Ha          , Ha          , Ha          , Ha          , Chr         , Ha          , Chr         , Chr         , Chr         , Chr         , Chr         , Chr         , Chr         , Rp          , Rr          , Rr          , Rr          , Rr          , Rr          , Chr         , Chr         , Chr         , Chr         , Chr         , Chr         , Ha          , Ha          , Ha          , Ha          , Ms          , Ha          
Ms          , Ha          , Ha          , Ms          , Ms          , Ha          , Ha          , Ha          , Ha          , Ha          , Ha          , Ha          , Ha          , Ha          , Ha          , Ha          , Ha          , Ha          , Ha          , Chr         , Ha          , Chr         , Rp          , Rp          , Rp          , Rp          , Chr         , Chr         , Chr         , Chr         , Chr         , Chr         , Chr         , Chr         , Chr         , Chr         , Ha          , Ha          , Ms          , Ms          , Ms          , Ms          
Ms          , Ha          , Ha          , Ms          , Ms          , Ha          , Ha          , Ha          , Ha          , Ha          , Ha          , Ha          , Ha          , Ha          , Ha          , Ms          , Ms          , Ha          , Ha          , Ha          , Ha          , Ha          , Rp          , Rp          , Rp          , Rp          , Chr         , Chr         , Chr         , Chr         , Chr         , Chr         , Ha          , Ha          , Ha          , Ha          , Ha          , Ms          , Ms          , Ms          , Ms          , Ms          
Mm^Xm       , Ha          , Ha          , Ha          , Re          , Ha          , Aa^Fpa      , Ha          , Ha          , Ha          , Ha          , Ha          , Aa^Fpa      , Ha          , Ha          , Ms          , Ms          , Ms          , Ms          , Ha          , Ha          , Ha          , Rp          , Rp          , Rp          , Ha          , Ha          , Chr         , Chr         , Chr         , Ha          , Ha          , Ha          , Ha          , Ha          , Ha          , Ms          , Ms          , Ms          , Ms          , Mm^Xm       , Mm^Xm       
Mm^Xm       , Mm^Xm       , Re          , Re          , Aa^Fpa      , Aa^Fpa      , Aa^Fpa      , Aa^Fpa      , Mm^Xm       , Mm^Xm       , Mm^Xm       , Aa^Fpa      , Aa^Fpa      , Aa^Fpa      , Aa^Fpa      , Ha          , Ha          , Ms          , Ha          , Ha          , Aa^Fpa      , Aa^Fpa      , Rp          , Rp          , Re^Vct      , Ha          , Ha          , Ha          , Ha          , Ha          , Ha          , Ha          , Ha          , Ha          , Ha^Fpa      , Ms          , Ms          , Ms          , Ms          , Mm^Xm       , Mm^Xm       , Mm^Xm       
Re          , Re          , Re          , Ha          , Aa^Fpa      , Aa^Fpa      , Aa^Fpa      , Mm^Xm       , Mm^Xm       , Mm^Xm       , Mm^Xm       , Aa^Fpa      , Aa^Fpa      , Aa^Fpa      , Aa^Fpa      , Aa^Fpa      , Aa^Fpa      , Ha          , Ha          , Aa^Fpa      , Aa^Fpa      , Aa^Fpa      , Rp          , Rp          , Aa^Fpa      , Ha          , Ha          , Ha          , Aa^Fpa      , Aa^Fpa      , Ha^Fpa      , Aa^Fpa      , Ha^Fpa      , Ha^Fpa      , Ha^Fpa      , Ha^Fpa      , Ha^Fpa      , Ms          , Ms          , Ms          , Ms          , Ms          
Re          , Re          , Re          , Ha          , Ha          , Aa^Fpa      , Aa^Fpa      , Mm^Xm       , Aa^Fpa      , Mm^Xm       , Ms          , Ms          , Aa^Fpa      , Aa^Fpa      , Aa^Fpa      , Aa^Fpa      , Aa^Fpa      , Ha          , Ha          , Aa^Fpa      , Re          , Aa^Fpa      , Re          , Rp          , Re          , Aa^Fpa      , Ha          , Aa^Fpa      , Ha^Fpa      , Ha^Fpa      , Ha^Fpa      , Ha^Fpa      , Ha^Fpa      , Ha^Fpa      , Ha^Fpa      , Ha^Fpa      , Ha^Fpa      , Ha^Fpa      , Ms          , Ms          , Ms          , Ms          
Mm^Xm       , Ha          , Ha          , Re          , Ha          , Ha          , Ha          , Aa^Fpa      , Aa^Fpa      , Ms          , Ms          , Ms          , Aa^Fpa      , Ha          , Re          , Aa^Fpa      , Re          , Ha^Vhha     , Re          , Re          , Re          , Re          , Re          , Re          , Re          , Aa^Fpa      , Ha          , Aa^Fpa      , Ha^Fpa      , Ha^Fpa      , Ha^Fpa      , Ha^Fpa      , Ha^Fpa      , Ha^Fpa      , Aa^Fpa      , Ha^Fpa      , Ms          , Ms          , Ms          , Ms          , Ms          , Ms          
Mm^Xm       , Mm^Xm       , Ms          , Ha          , Ha          , Ha          , Ha          , Ha          , Re          , Aa^Fpa      , Aa^Fpa      , Aa^Fpa      , Re          , Re          , Re          , Re          , Re          , Re          , Re          , Re          , Re          , Re          , Re          , Re          , Re          , Re          , Re          , Ha          , Ha          , Ha          , Ms          , Ms          , Ms          , Ha^Fpa      , Ms          , Ms          , Ms          , Ms          , Ms          , Ms          , Ms          , Ms          
Mm^Xm       , Ms          , Ms          , Ms          , Ha          , Ha          , Re          , Re          , Re          , Re          , Re          , Re          , Re          , Re          , Re          , Re          , Re          , Re          , Re          , Re          , Re          , Re          , Chr         , Re          , Re          , Re          , Re          , Re          , Ha          , Ms          , Ms          , Ms          , Mm^Xm       , Ms          , Mm^Xm       , Mm^Xm       , Mm^Xm       , Ms          , Ms          , Ms          , Ha          , Ms          
Mm^Xm       , Ms          , Ms          , Ms          , Ha          , Re          , Re          , Re          , Re          , Re          , Re          , Re          , Re          , Re          , Ha          , Re          , Ha          , Re          , Ha          , Re          , Re^Vct      , Chr         , Chr         , Chr         , Aa^Fpa      , Re          , Re          , Re          , Ha          , Ms          , Mm          , Mm          , Mm^Xm       , Mm^Xm       , Mm^Xm       , Mm^Xm       , Mm^Xm       , Ms          , Ha          , Ha          , Ha          , Ha          
Mm^Xm       , Mm^Xm       , Ms          , Ms          , Aa^Fpa      , Re          , Re          , Re          , Re          , Re          , Aa^Fpa      , Aa^Fpa      , Ha          , Aa^Fpa      , Ha          , Ha          , Ha          , Ha          , Ha          , Ha          , Ha          , Chr         , Chr         , Chr         , Aa^Fpa      , Re          , Re          , Re          , Ha          , Ms          , Mm          , Mm^Xm       , Mm^Xm       , Mm^Xm       , Mm^Xm       , Mm^Xm       , Mm          , Ha          , Ha^Fpa      , Ha          , Ha          , Ha          
Mm^Xm       , Ms          , Ms          , Ms          , Ms          , Re          , Re          , Re          , Ha          , Aa^Fpa      , Aa^Fpa      , Aa^Fpa      , Aa^Fpa      , Aa^Fpa      , Ha^Fpa      , Ha          , Ha          , Ha          , Ms          , Ha^Fpa      , Ha^Fpa      , Ha^Fpa      , Ha          , Ha          , Re          , Re          , Re          , Re          , Ha          , Ms          , Mm          , Mm^Xm       , Mm^Xm       , Mm^Xm       , Mm^Xm       , Mm          , Mm          , Ha^Fpa      , Ha^Fpa      , Ha^Fpa      , Ha^Fpa      , Ha          
Mm^Xm       , Mm^Xm       , Ms          , Ms          , Ms          , Re          , Re          , Re          , Ha          , Aa^Fpa      , Aa^Fpa      , Aa^Fpa      , Ha^Fpa      , Ha^Fpa      , Ha^Fpa      , Ha^Fpa      , Mm          , Ms          , Ms          , Ms          , Ms          , Ha          , Ha          , Aa^Fpa      , Re          , Re          , Re          , Ha          , Ms          , Ms          , Ms          , Mm^Xm       , Mm          , Mm^Xm       , Mm          , Mm          , Ha          , Ha^Fpa      , Ha^Fpa      , Ha^Fpa      , Aa^Fpa      , Aa^Fpa      
Mm          , Ms          , Aa^Fpa      , Ms          , Ha          , Re          , Re          , Re          , Re          , Ha          , Ha          , Aa^Fpa      , Ha^Fpa      , Ha^Fpa      , Mm          , Mm          , Mm          , Ms          , Ms          , Ms          , Ms          , Ha          , Re          , Re          , Re          , Re          , Ms          , Ms          , Ms          , Ms          , Ms          , Mm          , Mm          , Mm          , Ha          , Ha          , Ha          , Ha          , Ha^Fpa      , Ha^Fpa      , Aa^Fpa      , Aa^Fpa      
Mm          , Aa^Fpa      , Aa^Fpa      , Aa^Fpa      , Aa^Fpa      , Re          , Re          , Re          , Re          , Re          , Ha          , Ha          , Ha          , Ha^Fpa      , Ms          , Mm          , Ms          , Ms          , Ms          , Ms          , Re          , Re          , Re          , Re          , Re          , Re          , Ms          , Ms          , Ms          , Ms          , Ms          , Ms          , Ha          , Ha          , Ha          , Ha          , Ha          , Ha          , Ha^Fpa      , Ha^Fpa      , Aa^Fpa      , Aa^Fpa      
Mm          , Aa^Fpa      , Aa^Fpa      , Aa^Fpa      , Aa^Fpa      , Aa^Fpa      , Aa^Fpa      , Re          , Re          , Re          , Re          , Ha          , Ha          , Ms          , Ms          , Ms          , Ms          , Ms          , Re          , Re          , Re          , Re          , Re          , Re          , Aa^Fpa      , Aa^Fpa      , Ha^Fpa      , Ms          , Ha          , Ha          , Ms          , Ha          , Ha          , Ha          , Ha          , Ha          , Ha          , Ha^Fpa      , Ha^Fpa      , Aa^Fpa      , Aa^Fpa      , Aa^Fpa      
Mm          , Aa^Fpa      , Aa^Fpa      , Aa^Fpa      , Aa^Fpa      , Aa^Fpa      , Aa^Fpa      , Ha          , Re          , Re          , Re          , Re          , Re          , Ms          , Ms^Vhha     , Ms          , Re          , Re          , Re          , Re          , Re          , Re          , Aa          , Aa^Fpa      , Ha^Fpa      , Aa^Fpa      , Ha^Fpa      , Ha          , Ha          , Ha          , Ha          , Ha          , Ha^Fpa      , Ha^Fpa      , Ha^Fpa      , Ha^Fpa      , Ha^Fpa      , Ha^Fpa      , Aa^Fpa      , Aa^Fpa      , Aa^Fpa      , Aa^Fpa      
Mm          , Ha          , Ha          , Aa^Fpa      , Aa^Fpa      , Aa^Fpa      , Aa^Fpa      , Aa^Fpa      , Ha          , Re          , Re          , Re          , Re          , Re          , Re          , Re          , Re          , Re          , Re          , Re          , Aa          , Aa          , Ha          , Ha          , Ha^Fpa      , Ha^Fpa      , Ha          , Ha          , Ha          , Ha          , Ha          , Ha          , Ha^Fpa      , Ha^Fpa      , Ha^Fpa      , Ha^Fpa      , Ha^Fpa      , Ha^Fpa      , Aa^Fpa      , Aa^Fpa      , Aa^Fpa      , Ha          
Mm          , Ha          , Ha          , Ha          , Ha          , Aa^Fpa      , Aa^Fpa      , Aa^Fpa      , Ha          , Ha          , Ha          , Re          , Re          , Re          , Re          , Re          , Re          , Re          , Chr         , Re^Vct      , Ha          , Ha          , Ha          , Ha^Fpa      , Ha^Fpa      , Ha          , Ha          , Ha          , Mm^Xm       , Mm^Xm       , Mm^Xm       , Mm^Xm       , Mm^Xm       , Mm^Xm       , Ha^Fpa      , Ha^Fpa      , Mm^Xm       , Aa^Fpa      , Aa^Fpa      , Aa^Fpa      , Ha          , Ha          
Mm          , Aa^Fpa      , Aa^Fpa      , Ha          , Ha          , Ha          , Ha          , Ha          , Ha          , Ha          , Ha          , Ha          , Ha          , Re          , Re          , Re          , Re          , Chr         , 5 Khr       , Chr         , Ha          , Ha          , Ha          , Ha^Fpa      , Ha          , Ha          , Ha          , Mm^Xm       , Mm^Xm       , Mm^Xm       , Mm^Xm       , Mm^Xm       , Mm^Xm       , Mm^Xm       , Mm^Xm       , Mm^Xm       , Mm^Xm       , Mm^Xm       , Ha          , Ha          , Ha          , Ha          
Mm          , Aa^Fpa      , Aa^Fpa      , Ha          , Ha          , Ha          , Ha          , Ha          , Ha          , Ha          , Ha          , Ha          , Aa^Fpa      , Aa          , Re          , Re          , Re          , Chr         , Chr         , Chr         , Ha          , Ha          , Ha          , Ha          , Ha          , Ha          , Mm^Xm       , Mm^Xm       , Mm^Xm       , Mm^Xm       , Mm^Xm       , Mm^Xm       , Mm^Xm       , Mm^Xm       , Mm^Xm       , Mm^Xm       , Mm^Xm       , Mm^Xm       , Ha          , Ha          , Ha          , Ha          
Mm^Xm       , Mm          , Ha          , Ha          , Ha          , Ha          , Ha          , Ha          , Ha          , Ha          , Ha^Fpa      , Aa^Fpa      , Aa^Fpa      , Aa^Fpa      , Aa          , Re          , Re          , Re          , Re          , Re          , Ha          , Ha          , Ha          , Ha          , Ha          , Ha          , Mm^Xm       , Mm^Xm       , Mm^Xm       , Mm^Xm       , Mm^Xm       , Mm^Xm       , Ha^Fpa      , Mm^Xm       , Mm          , Mm          , Mm          , Mm          , Ha          , Ha          , Aa^Fpa      , Aa^Fpa      
Mm          , Mm^Xm       , Mm^Xm       , Ha          , Ha^Fpa      , Ha^Fpa      , Ha^Fpa      , Ha          , Ha          , Ha          , Ha^Fpa      , Ha^Fpa      , Ha^Fpa      , Aa^Fpa      , Ha          , Re          , Re          , Re          , Re          , Re          , Re          , Ha          , Ha          , Ha          , Ha          , Ha          , Ha          , Ha          , Ha          , Ha          , Ha          , Mm          , Ha^Fpa      , Mm          , Ha          , Ha          , Ha          , Mm          , Ha          , Ha          , Aa^Fpa      , Aa^Fpa      
Ha^Fpa      , Mm          , Mm^Xm       , Mm^Xm       , Ha^Fpa      , Ha^Fpa      , Ha^Fpa      , Ha^Fpa      , Ha          , Ha          , Ha          , Ha          , Ha          , Ha          , Ha          , Ha          , Ha          , Aa          , Chr         , Re          , Re          , Ha          , Ha          , Ha          , Ha          , Ha          , Ha          , Ha          , Ha          , Ha          , Ha          , Ha^Fpa      , Ha^Fpa      , Ha^Fpa      , Ha          , Ha          , Ha          , Mm          , Ha          , Aa^Fpa      , Aa^Fpa      , Aa^Fpa      
Ha^Fpa      , Mm          , Ha          , Mm^Xm       , Mm^Xm       , Ha^Fpa      , Ha^Fpa      , Ha^Fpa      , Ha^Fpa      , Ha          , Ha          , Ha          , Ha          , Ha          , Ha          , Ha          , Ha          , Ha          , Re          , Re          , Re          , Re          , Re          , Ha          , Ha          , Ha          , Ha          , Ha          , Ha          , Ha          , Aa^Fpa      , Aa^Fpa      , Aa^Fpa      , Aa^Fpa      , Aa^Fpa      , Ha          , Ha          , Ha          , Ha          , Aa^Fpa      , Aa^Fpa      , Aa^Fpa      
Ha^Fpa      , Ha^Fpa      , Ha          , Mm          , Mm          , Mm^Xm       , Mm^Xm       , Ha^Fpa      , Mm          , Ha^Fpa      , Ha          , Ha          , Ha          , Ha          , Ha          , Ha          , Ha          , Ha          , Re          , Re          , Re          , Re          , Re          , Ha          , Ha          , Ha          , Ha          , Ha          , Aa^Fpa      , Aa^Fpa      , Aa^Fpa      , Aa^Fpa      , Aa^Fpa      , Aa^Fpa      , Aa^Fpa      , Ha          , Ha          , Ha          , Ha          , Aa^Fpa      , Aa^Fpa      , Aa^Fpa      
Aa^Fpa      , Ha^Fpa      , Ha^Fpa      , Ha          , Ha          , Mm          , Mm^Xm       , Mm^Xm       , Mm^Xm       , Mm          , Mm          , Ha          , Ha          , Ha          , Ha          , Ha          , Ha          , Ha          , Aa^Fpa      , Re          , Re          , Re          , Re          , Re          , Re          , Ha          , Aa^Fpa      , Aa^Fpa      , Aa^Fpa      , Aa^Fpa      , Aa^Fpa      , Aa^Fpa      , Aa^Fpa      , Aa^Fpa      , Ha          , Ha          , Ha          , Ha          , Ha          , Ha          , Aa^Fpa      , Aa^Fpa      
Aa^Fpa      , Aa^Fpa      , Aa^Fpa      , Ha          , Ha          , Mm          , Mm          , Mm^Xm       , Mm          , Mm^Xm       , Mm          , Ha          , Ha          , Ha          , Ha          , Ha          , Aa^Fpa      , Aa^Fpa      , Aa^Fpa      , Aa^Fpa      , Aa^Fpa      , Re          , Re          , Re          , Re          , Re          , Aa^Fpa      , Aa^Fpa      , Aa^Fpa      , Aa^Fpa      , Aa^Fpa      , Aa^Fpa      , Ha          , Ha          , Ha          , Ha          , Ha          , Ha          , Aa^Fpa      , Aa^Fpa      , Aa^Fpa      , Aa^Fpa      
Aa^Fpa      , Aa^Fpa      , Aa^Fpa      , Ha          , Ha          , Ha          , Ha          , Mm          , Mm          , Mm          , Ha          , Ha          , Ha          , Ha          , Ha          , Ha          , Aa^Fpa      , Aa^Fpa      , Aa^Fpa      , Aa^Fpa      , Aa^Fpa      , Aa^Fpa      , Re          , Re          , Re          , Re          , Re          , Aa^Fpa      , Ha          , Aa^Fpa      , Ha          , Ha          , Ha          , Ha          , Ha          , Ha          , Ha          , Ha          , Aa^Fpa      , Aa^Fpa      , Aa^Fpa      , Aa^Fpa      
Aa^Fpa      , Aa^Fpa      , Aa^Fpa      , Aa^Fpa      , Aa^Fpa      , Ha          , Ha          , Ha          , Ha          , Ha          , Ha          , Ha          , Ha          , Ha          , Ha          , Ha          , Aa^Fpa      , Aa^Fpa      , Aa^Fpa      , Aa^Fpa      , Ha^Fpa      , Ha^Fpa      , Ha          , Re          , Re          , Re          , Re          , Re          , Re          , Ha          , Re          , Ha          , Ha          , Ha          , Ha          , Ha          , Ha          , Aa^Fpa      , Aa^Fpa      , Aa^Fpa      , Aa^Fpa      , Aa^Fpa      
Aa          , Aa^Fpa      , Aa^Fpa      , Aa^Fpa      , Aa^Fpa      , Aa^Fpa      , Aa          , Ha          , Aa          , Ha          , Aa          , Ha          , Aa          , Ha          , Aa^Fpa      , Aa^Fpa      , Aa^Fpa      , Aa^Fpa      , Aa^Fpa      , Aa^Fpa      , Ha^Fpa      , Ha          , Ha          , Ha          , Ha          , Re          , Re          , Re          , Re          , Re          , Re          , Re          , Re          , Re          , Ce          , Aa          , Aa          , Aa^Fpa      , Aa^Fpa      , Aa^Fpa      , Aa^Fpa      , Aa          
Aa          , Aa^Fpa      , Aa^Fpa      , Aa^Fpa      , Aa^Fpa      , Aa^Fpa      , Aa          , Aa          , Aa          , Aa          , Aa          , Aa          , Aa          , Aa          , Aa^Fpa      , Aa^Fpa      , Aa^Fpa      , Aa^Fpa      , Aa^Fpa      , Aa^Fpa      , Aa^Fpa      , Ha^Fpa      , Aa          , Ha          , Aa          , Aa          , Re          , Re          , Re          , Re          , Re          , Re          , Re          , Re          , Ce          , Ce          , Aa          , Aa^Fpa      , Aa^Fpa      , Aa^Fpa      , Aa          , Aa          
Aa          , Aa          , Aa          , Aa^Fpa      , Aa^Fpa      , Aa^Fpa      , Aa          , Aa          , Aa          , 3 Aa        , Aa          , Aa          , Aa          , Aa          , Aa^Fpa      , Aa^Fpa      , Aa^Fpa      , Aa^Fpa      , Aa^Fpa      , Aa^Fpa      , Aa^Fpa      , Aa^Fpa      , Aa^Fpa      , Aa          , Aa          , Aa          , Aa          , Re          , Re          , Re          , Re^Vct      , Re          , Ce          , Ce          , 1 Ke        , Ce          , Re          , Aa          , Aa          , Aa          , Aa          , Aa          
Aa          , Aa          , Aa          , Aa          , Aa          , Aa          , Aa          , Aa          , Aa          , Aa          , Aa          , Aa          , Aa          , Aa          , Aa^Fpa      , Aa^Fpa      , Aa^Fpa      , Aa^Fpa      , Aa^Fpa      , Aa^Fpa      , Aa^Fpa      , Aa^Fpa      , Aa^Fpa      , Aa^Fpa      , Aa          , Aa          , Aa          , Aa          , Aa          , Aa          , Aa          , Aa          , Aa          , Re          , Re          , Re          , Re          , Aa          , Aa          , Aa          , Aa          , Aa          
