border_size=1
usage=map

Mm^Xm       , Mm^Xm       , Ms          , Ms          , Ms          , Ms          , Ms          , Ms          , Ms          , Aa          , Aa          , Aa          , Aa          , Aa          , Rr          , Rr          , Rr          , Mm^Xm       , Mm^Xm       , Aa          , Mm^Xm       , Mm^Xm       , Mm^Xm       , Mm^Xm       , Mm^Xm       , Mm^Xm       , Mm^Xm       , Mm^Xm       , Mm^Xm       , Ms          , Ms          , Ms          , Mm^Xm       , Mm^Xm       , Mm^Xm       , Mm^Xm       , Mm^Xm       , Mm^Xm       , Mm^Xm       , Mm^Xm       , Mm^Xm       , Mm^Xm       
Mm^Xm       , Mm^Xm       , Mm^Xm       , Ms          , Ms          , Ms          , Ms          , Ms          , Ms          , Aa^Vca      , Aa          , Aa          , Aa          , Aa          , Rr          , Rr          , Rr          , Rr          , Rr          , Mm^Xm       , Mm^Xm       , Mm^Xm       , Mm^Xm       , Mm^Xm       , Ms          , Mm^Xm       , Ms          , Ms          , Ms          , Ms          , Mm^Xm       , Ms          , Ms          , Ms          , Ms          , Mm^Xm       , Mm^Xm       , Mm^Xm       , Mm^Xm       , Mm^Xm       , Mm^Xm       , Mm^Xm       
Mm^Xm       , Mm^Xm       , Mm^Xm       , Ms          , Ms          , Ms          , Ms          , Ms          , Ms          , Aa          , Aa          , Aa          , Mm^Xm       , Aa          , Aa          , Rr          , Rr          , Rr          , Rr          , Rr          , Mm^Xm       , Mm^Xm       , Mm^Xm       , Mm^Xm       , Ms          , Ms          , Ms          , Ms          , Ms          , Ms          , Ms          , Mm^Xm       , Mm^Xm       , Mm^Xm       , Mm^Xm       , Mm^Xm       , Mm^Xm       , Mm^Xm       , Mm^Xm       , Mm^Xm       , Mm^Xm       , Mm^Xm       
Mm^Xm       , Mm^Xm       , Ms          , Ms          , Mm          , Mm          , Mm          , Ms          , Chr         , Aa          , Mm          , Mm^Xm       , Mm^Xm       , Mm          , Aa          , Aa          , Aa^Vca      , Rr          , Rr          , Rr          , Rr          , Mm^Xm       , Mm^Xm       , Mm          , Ha          , Ha          , Ha^Fpa      , Ms          , Ms          , Ms          , Ms          , Ms          , Ms          , Ms          , Ms          , Ms          , Ms          , Mm^Xm       , Mm^Xm       , Mm^Xm       , Mm^Xm       , Mm^Xm       
Mm^Xm       , Mm^Xm       , Mm^Xm       , Mm^Xm       , Mm          , Mm          , Mm          , Mm          , Mm          , Mm          , Ha          , Mm^Xm       , Mm          , Mm^Xm       , Aa          , Aa          , Aa          , Rr          , Rr          , Rr          , Rr          , Ha          , Ha          , Ha          , Aa          , Aa          , Aa          , Ha^Fpa      , Ha^Fpa      , Ha^Fpa      , Ha^Fpa      , Ms          , Ms          , Ms          , Ms          , Ms          , Ms          , Ms          , Ms          , Mm^Xm       , Mm^Xm       , Mm^Xm       
Mm^Xm       , Mm^Xm       , Mm^Xm       , Mm          , Ms          , Mm          , Mm          , Mm          , Ha          , Ha          , Ha          , Chr         , Aa          , Aa          , Chr         , Aa          , Aa          , Aa          , Aa          , Rr          , Rr          , Rr          , Chr         , Aa          , Aa          , Aa          , Chr         , Aa          , Ha          , Ha^Fpa      , Ha          , Ha^Fpa      , Ha^Fpa      , Ms          , Ha^Fpa      , Ha^Fpa      , Ha^Fpa      , Ms          , Ms          , Mm^Xm       , Mm^Xm       , Mm^Xm       
Mm^Xm       , Mm^Xm       , Hh          , Ms          , Hh          , Mm          , Ha          , Ha          , Ha^Fpa      , Ha          , Aa          , Aa          , Aa          , Aa          , Aa          , Aa          , Aa          , Chr         , Aa          , Aa          , Rr          , Rr          , Rr          , Aa          , Aa          , Aa          , Ha          , Ha          , Ms          , Ms          , Ms          , Ha          , Ha          , Ha^Fpa      , Ha          , Ha          , Ms          , Ms          , Ms          , Ms          , Mm^Xm       , Mm^Xm       
Mm          , Mm          , Ms          , Hh          , Ha^Fpa      , Re          , Re          , Re          , Re          , Re          , Aa          , Aa          , Aa          , Aa          , Aa          , Aa^Vca      , Aa          , Aa          , Aa          , Aa          , Rr          , Rr          , Rr          , Aa          , Aa          , Ha          , Ha          , Ms          , Mm^Xm       , Mm^Xm       , Mm^Xm       , Ms          , Ha          , Ha          , Ha          , Ms          , Ms          , Ms          , Ms          , Ms          , Ms          , Ms          
Mm^Xm       , Mm^Xm       , Ms          , Ms          , Ms          , Aa          , Aa          , Aa^Fpa      , Aa          , Aa          , Hh          , Hh          , Hh          , Hh          , Hh          , Aa          , Aa          , Aa          , Aa          , Aa          , Rr          , Rr          , Rr          , Chr         , Aa          , Ha          , Ha          , Ms          , Mm^Xm       , Mm^Xm       , Mm^Xm       , Ms          , Ha          , Ha          , Ha          , Ha          , Mm          , Mm          , Mm          , Ms          , Mm          , Ms          
Mm^Xm       , Mm^Xm       , Ms          , Ms          , Ms          , Aa          , Aa          , Aa          , Hh          , Hh          , Mm          , Mm          , Mm          , Mm          , Mm          , Hh          , Aa          , Aa          , Aa          , Aa          , Rr          , Rr          , Rr          , Rr          , Aa          , Aa          , Ha          , Ms          , Ms          , Mm^Xm       , Ms          , Ms          , Ha          , Aa          , Aa          , Hh          , Mm          , Mm          , Mm          , Mm          , Mm          , Mm          
Mm^Xm       , Mm^Xm       , Ms          , Ms          , Ms          , Ha^Fpa      , Ha          , Hh          , Mm          , Mm          , Mm          , Mm          , Uh          , Mm          , Mm          , Hh          , Hh          , Aa          , Aa          , Aa          , Aa          , Rr          , Rr          , Rr          , Rr          , Aa          , Ha          , Ha          , Ha          , Ms          , Ha^Fpa      , Ha^Fpa      , Ha^Fpa      , Aa          , Aa          , Hh          , Hh          , Mm          , Mm          , Mm          , Mm          , Mm          
Mm^Xm       , Mm^Xm       , Mm^Xm       , Ms          , Ms          , Ha          , Ha          , Mm          , Mm^Xm       , Mm^Xm       , Mm          , Uh          , Ql          , Uh          , Mm          , Mm          , Mm          , Hh          , Hh          , Aa          , Aa          , Rr          , Rr          , Rr          , Rr          , Aa          , Aa          , Ha          , Ha          , Ha          , Ha^Fpa      , Ha^Fpa      , Aa^Fpa      , Aa^Fpa      , Aa^Fpa      , Hh          , Hh^Fp       , Hh^Fp       , Hh^Fp       , Mm          , Hh^Fp       , Hh^Fp       
Mm^Xm       , Mm^Xm       , Mm^Xm       , Ms          , Ms          , Ha          , Ha          , Mm          , Mm          , Mm          , Mm          , Uh          , Uh          , Uh          , Mm          , Mm          , Mm          , Mm          , Hh          , Ha          , Aa          , Aa          , Rr          , Rr          , Aa          , Aa          , Aa          , Ha^Fpa      , Ha          , Ha          , Aa          , Aa          , Aa^Fpa      , Aa^Fpa      , Re          , Hh^Fp       , Hh^Fp       , Hh^Fp       , Uh          , Hh^Fp       , Hh^Fp       , Hh^Fp       
Mm^Xm       , Mm^Xm       , Mm^Xm       , Ms          , Ms          , Ha          , Ha          , Hh          , Hh          , Mm          , Mm          , Mm          , Hh^Fp       , Hh^Fp       , Hh^Fp       , Hh^Fp       , Aa^Fpa      , Mm          , Hh          , Ha          , Aa          , Rr          , Rr          , Rr          , Aa          , Aa          , Aa          , Aa          , Ha          , Ha          , Aa          , Aa          , Aa^Fpa      , Aa          , Re          , Re          , Re          , Uh          , Ql          , Uh          , Mm          , Mm          
Mm^Xm       , Mm^Xm       , Hh^Fp       , Ms          , Ms          , Ha          , Ha          , Ha          , Ha          , Hh          , Hh          , Mm          , Gs^Fp       , Hh^Fp       , Hh^Fp       , Gs^Fp       , Aa^Fpa      , Aa^Fpa      , Aa          , Aa          , Aa          , Rr          , Rr          , Rr          , Aa          , Aa          , Aa          , Aa          , Re          , Ha          , Re          , Re          , Re          , Re          , Re          , Re          , Re          , Uh          , Uh          , Uh          , Mm          , Mm          
Hh          , Hh          , Hh^Fp       , Ms          , Aa          , Aa^Vca      , Aa          , Ha          , Aa          , Aa          , Aa          , Hh          , Aa          , Gs^Fp       , Aa^Fpa      , Hh^Fp       , Aa^Fpa      , Aa^Fpa      , Aa          , Aa          , Aa          , Aa          , Rr          , Rr          , Rr          , Aa          , Aa          , Aa          , Ai          , Re          , Aa          , Ha          , Aa          , Aa          , Aa          , Aa          , Aa          , Mm          , Mm          , Mm          , Mm          , Mm          
Hh          , Hh          , Ms          , Hh          , Re          , Aa          , Ha          , Aa          , Aa          , Aa          , Aa          , Aa          , Aa          , Aa          , Aa          , Aa^Fpa      , Aa          , Aa          , Aa          , Aa          , Aa          , Aa^Fpa      , Rr          , Rr          , Rr          , Aa          , Aa          , Ai          , Wo          , Ai          , Aa          , Aa          , Aa          , Aa          , Aa          , Aa          , Aa          , Ha          , Mm          , Mm          , Mm          , Mm          
Mm^Xm       , Mm^Xm       , Ms          , Ha          , Ha          , Ha          , Ha          , Ha          , Aa          , Aa          , Aa          , Aa          , Aa          , Aa          , Aa          , Aa          , Aa          , Aa          , Chr         , Chr         , Chr         , Aa          , Rr          , Rr          , Ha          , Aa          , Aa          , Ai          , Ai          , Ai          , Aa          , Aa          , Aa          , Aa          , Aa          , Aa          , Ha          , Ha          , Mm          , Mm          , Mm          , Mm          
Mm^Xm       , Mm^Xm       , Ms          , Ms          , Ha^Fpa      , Ha          , Ha^Fpa      , Ha          , Ha          , Aa          , Aa          , Aa          , Aa          , Aa          , Aa          , Aa^Vca      , Aa          , Aa          , Chr         , 2 Khr       , Chr         , Rr          , Rr          , Rr          , Ha          , Aa          , Aa          , Aa          , Aa^Vca      , Aa          , Aa          , Aa          , Aa          , Aa          , Aa          , Aa          , Aa          , Ha          , Ha          , Mm          , Mm          , Mm          
Mm^Xm       , Mm^Xm       , Ms          , Ms          , Ha^Fpa      , Ha          , Ha          , Ha          , Ha          , Aa          , Aa          , Aa          , Aa          , Aa          , Aa          , Aa          , Rr          , Rr          , Rr          , Chr         , Rr          , Rr          , Rr          , Rr          , Ha          , Aa          , Aa          , Aa          , Aa          , Aa          , Aa          , Aa^Fpa      , Aa^Fpa      , Aa          , Aa^Fpa      , Aa          , Aa          , Aa          , Aa          , Mm          , Hh          , Mm          
Mm^Xm       , Mm^Xm       , Ms          , Ms          , Ha          , Ha          , Ha          , Ha          , Aa          , Aa          , Aa          , Aa          , Aa          , Aa          , Rr          , Rr          , Rr          , Rr          , Rr          , Rr          , Rr          , Rr          , Ha          , Ha          , Aa          , Aa          , Aa          , Aa          , Aa          , Aa          , Aa          , Aa          , Aa          , Aa^Fpa      , Aa^Fpa      , Aa^Fpa      , Gs^Fp       , Gs^Fp       , Gs^Fp       , Hh          , Hh          , Hh          
Mm^Xm       , Mm^Xm       , Ms          , Ms          , Ha          , Aa          , Aa          , Aa          , Aa          , Aa          , Aa          , Aa          , Rr          , Rr          , Rr          , Rr          , Rr          , Rr          , Aa          , Rr          , Rr          , Rr          , Aa          , Aa          , Aa          , Aa          , Aa          , Aa          , Ha          , Aa          , Aa          , Aa          , Aa          , Aa          , Aa^Fpa      , Aa^Fpa      , Aa^Fpa      , Gs^Fp       , Hh          , Gs^Fp       , Hh          , Hh          
Mm^Xm       , Mm^Xm       , Mm^Xm       , Ms          , Ha          , Ha          , Aa          , Aa          , Aa          , Aa          , Aa          , Aa          , Rr          , Rr          , Rr          , Rr          , Aa          , Aa          , Aa          , Aa          , Aa          , Aa          , Aa          , Aa          , Aa          , Aa          , Ha          , Ha          , Ha^Fpa      , Aa          , Aa          , Aa          , Aa          , Aa^Fpa      , Aa^Fpa      , Aa^Fpa      , Gs^Fp       , Gs^Fp       , Hh^Fp       , Hh          , Hh^Fp       , Hh^Fp       
Mm^Xm       , Mm^Xm       , Ms          , Ms          , Ha          , Ha          , Aa          , Aa          , Re^Vct      , Aa          , Ce          , Rr          , Rr          , Rr          , Aa          , Aa          , Aa          , Aa          , Aa          , Aa          , Mm          , Aa          , Gg^Vc       , Aa          , Chr         , Rr          , Rr          , Ha          , Ha          , Aa          , Aa          , Aa          , Aa          , Aa          , Aa          , Aa^Fpa      , Aa^Fpa      , Gs^Fp       , Mm          , Hh^Fp       , Mm          , Mm          
Mm^Xm       , Ms          , Ms          , Ha          , Ha          , Ha          , Aa          , Aa          , Aa          , Aa          , Ce          , Ce          , Rr          , Rr          , Re^Vct      , Aa          , Aa          , Ha          , Ms          , Mm          , Uh          , Hh^Fp       , Hh^Fp       , Chr         , Rr          , Rr          , Rr          , Ha          , Ha          , Aa          , Aa          , Aa          , Aa          , Aa          , Aa          , Aa          , Aa          , Aa^Fpa      , Mm          , Mm          , Mm          , Mm          
Mm^Xm       , Mm^Xm       , Ms          , Ha^Fpa      , Ha          , Ha          , Aa          , Aa          , Re^Vct      , Aa          , Ce          , 1 Ke        , Rr          , Rr          , Rr          , Aa          , Aa          , Ha          , Ms          , Mm          , Mm          , Uh          , Ql          , Uh          , Mm          , Rr          , Chr         , Ha          , Aa          , Aa          , Aa          , Aa          , Aa          , Aa          , Aa          , Aa          , Aa          , Mm          , Mm          , Mm          , Mm^Xm       , Mm          
Mm^Xm       , Mm^Xm       , Ms          , Ms          , Ha          , Ha          , Aa          , Aa          , Aa          , Aa          , Ce          , Ce          , Rr          , Rr          , Rr          , Re^Vct      , Aa          , Ha          , Ha^Fpa      , Ms          , Mm          , Uh          , Uh          , Uh          , Mm          , Chr         , Aa          , Aa          , Aa          , Aa          , Aa          , Aa          , Aa          , Aa          , Aa          , Aa          , Aa          , Mm          , Mm          , Mm          , Mm^Xm       , Mm          
Mm^Xm       , Mm^Xm       , Ms          , Ms          , Ha          , Aa          , Ha          , Ha          , Aa          , Aa          , Aa          , Aa          , Rr          , Rr          , Rr          , Rr          , Aa          , Aa^Fpa      , Ha^Fpa      , Ha^Fpa      , Hh          , Mm          , Mm          , Mm          , Ha          , Ha          , Aa          , Aa          , Aa          , Aa          , Aa          , Aa^Vca      , Aa          , Aa          , Aa          , Aa          , Aa          , Mm          , Mm          , Mm          , Mm^Xm       , Mm          
Mm^Xm       , Mm^Xm       , Ms          , Ms          , Ha          , Ha          , Ha          , Ha          , Aa          , Aa          , Aa          , Aa          , Aa          , Rr          , Rr          , Rr          , Rr          , Aa          , Aa^Fpa      , Ha          , Ha          , Mm          , Mm          , Mm          , Ha          , Aa          , Aa          , Aa          , Aa          , Aa          , Aa          , Aa          , Aa          , Aa          , Aa          , Aa          , Aa          , Aa          , Ms          , Ms          , Mm^Xm       , Mm^Xm       
Mm^Xm       , Mm^Xm       , Ms          , Ms          , Ha^Fpa      , Ha          , Ha          , Aa          , Aa          , Aa          , Aa          , Aa          , Aa          , Rr          , Rr          , Rr          , Rr          , Aa          , Aa          , Aa          , Aa          , Ha          , Ha          , Hh          , Ha          , Aa          , Aa          , Aa          , Aa          , Aa          , Aa          , Aa          , Aa          , Aa          , Aa          , Aa          , Aa          , Aa          , Ms          , Ms          , Mm^Xm       , Mm^Xm       
Mm^Xm       , Mm^Xm       , Ms          , Ms          , Ms          , Ha          , Ha          , Ha          , Ha          , Aa          , Ha          , Aa          , Aa          , Aa          , Rr          , Rr          , Rr          , Rr          , Rr          , Aa          , Aa          , Aa          , Aa          , Ha          , Aa          , Aa          , Aa          , Aa          , Aa^Fpa      , Aa          , Aa          , Aa          , Aa          , Aa          , Aa          , Aa          , Ha^Fpa      , Ha^Fpa      , Ms          , Ms          , Mm^Xm       , Mm^Xm       
Mm^Xm       , Mm^Xm       , Ms          , Ms          , Ms          , Ms          , Ha          , Ha          , Ha^Fpa      , Ha          , Ha          , Ai          , Aa          , Aa          , Aa          , Rr          , Rr          , Rr          , Rr          , Rr          , Rr          , Aa          , Aa          , Aa          , Aa          , Aa          , Aa          , Aa          , Aa^Fpa      , Aa^Fpa      , Aa^Fpa      , Aa^Fpa      , Aa^Fpa      , Aa          , Aa          , Aa          , Ha^Fpa      , Ha^Fpa      , Ha^Fpa      , Ms          , Ms          , Mm^Xm       
Mm^Xm       , Mm^Xm       , Ms          , Ms          , Ms          , Ms          , Ha          , Ha^Fpa      , Ha^Fpa      , Ha^Fpa      , Aa          , Aa          , Aa          , Aa          , Ha          , Rr          , Rr          , Rr          , Rr          , Rr          , Rr          , Rr          , Rr          , Aa          , Aa          , Aa          , Ha          , Aa          , Aa          , Aa^Fpa      , Aa^Fpa      , Aa^Fpa      , Aa^Fpa      , Aa^Fpa      , Aa          , Aa          , Ha^Fpa      , Ha^Fpa      , Ha^Fpa      , Ms          , Ms          , Mm^Xm       
Mm^Xm       , Mm^Xm       , Mm^Xm       , Ms          , Ms          , Ms          , Ms          , Ha          , Ha          , Ha          , Aa          , Aa          , Aa          , Ha          , Ha          , Ha          , Aa          , Rr          , Aa          , Rr          , Rr          , Rr          , Rr          , Aa          , Aa          , Ha          , Aa          , Aa          , Aa          , Aa          , Aa^Fpa      , Aa^Fpa      , Aa^Fpa      , Aa^Fpa      , Aa          , Ha^Fpa      , Ha^Fpa      , Ha^Fpa      , Ms          , Ms          , Mm^Xm       , Mm^Xm       
Mm^Xm       , Mm^Xm       , Mm^Xm       , Ms          , Ms          , Ms          , Ms          , Ms          , Ha          , Ha          , Chr         , Aa          , Aa          , Aa          , Aa          , Aa          , Aa          , Aa          , Chr         , Aa          , Rr          , Rr          , Chr         , Rr          , Rr          , Aa          , Aa          , Aa          , Aa          , Aa          , Aa          , Aa          , Aa          , Aa          , Aa          , Aa          , Ha^Fpa      , Ha^Fpa      , Ms          , Ms          , Mm^Xm       , Ms          
Mm^Xm       , Mm^Xm       , Mm^Xm       , Ms          , Ms          , Ms          , Ms          , Ms          , Ms          , Ha          , Ha          , Ha          , Ha          , Chr         , Aa          , Chr         , Aa          , Aa          , Aa          , Aa          , Aa          , Rr          , Rr          , Rr          , Rr          , Rr          , Aa          , Chr         , Aa          , Aa          , Aa          , Chr         , Aa          , Aa          , Aa          , Chr         , Ha^Fpa      , Ha^Fpa      , Ms          , Ms          , Mm^Xm       , Mm^Xm       
Mm^Xm       , Mm^Xm       , Mm^Xm       , Ms          , Ms          , Ms          , Ms          , Ms          , Ms          , Ha          , Ha          , Ha          , Ha          , Ha          , Ha          , Aa          , Aa          , Aa          , Aa          , Aa          , Aa          , Rr          , Rr          , Rr          , Rr          , Rr          , Aa          , Aa          , Aa          , Aa          , Aa          , Aa          , Aa          , Aa          , Ha^Fpa      , Ha^Fpa      , Ha^Fpa      , Ha^Fpa      , Ms          , Ms          , Ms          , Mm^Xm       
