border_size=1
usage=map

Mm          , Mm          , Hh^Fp       , Hh^Fp       , Hh^Fp       , Mm          , Mm          , Mm          , Mm          , Mm^Xm       , Mm^Xm       , Mm          , Mm          , Mm          , Mm          , Xu          , Uu          , Uu          , Ur          , Ur          , Xu          , Mm          , Mm^Xm       , Mm^Xm       , Mm^Xm       , Mm          , Mm          , Mm          , Mm          , Hh          , Gs^Fms      , Gs^Fms      , Gs^Fp       , Gs^Fms      , Gs^Fms      
Mm          , Mm          , Hh^Fp       , Hh^Fp       , Hh^Fp       , Mm          , Mm          , Mm          , Mm^Xm       , Mm^Xm       , Mm^Xm       , Mm^Xm       , Mm          , Mm          , Xu          , Xu          , Uu          , Ur          , Uu          , Ur          , Xu          , Mm          , Mm          , Mm^Xm       , Mm^Xm       , Mm^Xm       , Mm^Xm       , Mm          , Mm          , Hh          , Gs^Fms      , Gs^Fms      , Gs^Fp       , Gs^Fms      , Gs^Fms      
Mm          , Hh^Fp       , Hh^Fp       , Hh^Fp       , Hh^Fp       , Mm          , Mm          , Mm^Xm       , Mm^Xm       , Mm^Xm       , Mm^Xm       , Mm^Xm       , Mm          , Mm          , Xu          , Uu^Dr       , Ds          , Ds          , Ds          , Uu          , Uu          , Xu          , Mm          , Mm^Xm       , Mm^Xm       , Mm^Xm       , Mm^Xm       , Mm          , Mm          , Hh          , Gs^Fms      , Gs^Fms      , Gs^Fp       , Gs^Fp       , Gs^Fms      
Hh^Fp       , Hh^Fp       , Hh^Fp       , Hh^Fp       , Mm          , Mm          , Mm^Xm       , Mm^Xm       , Mm^Xm       , Mm^Xm       , Mm          , Mm          , Mm          , Mm          , Uu          , Uu          , Ds          , Ds          , 1 Uu        , Ds          , Uu          , Xu          , Hh          , Mm          , Mm          , Mm^Xm       , Mm^Xm       , Mm          , Mm          , Hh          , Hh          , Gs^Fms      , Gs^Fms      , Gs^Fp       , Gs^Fms      
Hh^Fp       , Hh^Fp       , Hh^Fp       , Hh^Fp       , Mm          , Mm          , Mm^Xm       , Mm^Xm       , Mm^Xm       , Mm          , Hh          , Hh          , Hh          , Hh          , Gg          , Ds          , Ds          , Ds          , Ds          , Ds          , Gg          , Xu          , Hh          , Hh          , Mm          , Mm          , Mm^Xm       , Mm^Xm       , Mm          , Hh          , Mm          , Hh          , Hh          , Gs^Fms      , Gs^Fms      
Hh^Fp       , Hh^Fp       , Hh^Fp       , Hh^Fp       , Mm          , Mm          , Mm^Xm       , Mm^Xm       , Mm          , Hh^Fp       , Hh^Fp       , Hh          , Gg          , Gg          , Ds          , Ds          , Ds          , Ds          , Ds          , Ds          , Gg          , Gg          , Hh          , Hh          , Hh          , Mm          , Mm          , Mm^Xm       , Mm^Xm       , Mm          , Mm          , Mm          , Hh          , Gs^Fms      , Gs^Fms      
Hh^Fp       , Hh^Fp       , Hh^Fp       , Hh^Fp       , Mm          , Mm          , Mm^Xm       , Mm^Xm       , Mm          , Mm          , Hh          , Gg          , Gg          , Gg          , Ds          , Ds          , Ds          , Ds          , Ds          , Ds          , Gg          , Hh          , Hh          , Hh          , Hh          , Mm          , Mm          , Mm^Xm       , Mm^Xm       , Mm^Xm       , Mm          , Hh          , Gs^Fms      , Gs^Fms      , Gs^Fds      
Hh^Fp       , Hh^Fp       , Hh^Fp       , Hh^Fp       , Mm          , Mm          , Mm          , Mm^Xm       , Mm          , Mm          , Hh          , Gg          , Gg          , Gg          , Ds          , Ds          , Ds^Dr       , Rp          , Ds          , Ds          , Gg          , Hh          , Hh          , Mm          , Hh          , Hh          , Mm          , Mm^Xm       , Mm^Xm       , Mm          , Mm          , Hh          , Gs^Fms      , Gs^Fds      , Gs^Fms      
Hh^Fp       , Hh^Fp       , Hh^Fp       , Hh^Fp       , Mm          , Mm          , Mm^Xm       , Mm^Xm       , Mm^Xm       , Mm          , Hh          , Gg          , Hh          , Gg          , Gg          , Ds          , Ds          , Ds          , Ds          , Ds          , Gg          , Hh          , Gg          , Hh          , Gg          , Hh          , Mm          , Mm          , Mm^Xm       , Mm^Xm       , Mm          , Hh          , Hh          , Gs^Fms      , Gs^Fms      
Hh^Fp       , Hh^Fp       , Hh^Fp       , Hh^Fp       , Mm          , Mm          , Mm          , Mm^Xm       , Mm^Xm       , Mm          , Hh          , Gg          , Gs^Fp       , Gg          , Gg          , Gg          , Gg          , Ds          , Ds          , Ds          , Rp          , Gg          , Gg          , Gg          , Gg          , Hh          , Hh          , Mm          , Mm^Xm       , Mm^Xm       , Mm^Xm       , Mm          , Hh          , Gs^Fms      , Gs^Fms      
Hh^Fp       , Hh^Fp       , Gs^Fp       , Hh^Fp       , Hh^Fp       , Mm          , Mm          , Mm^Xm       , Mm^Xm       , Mm          , Hh          , Gg          , Gg          , Gg          , Hh          , Hh          , Hh          , Gg          , Gg          , Ds          , Rp          , Gg          , Gg          , Gg          , Gg          , Hh^Fp       , Hh          , Mm          , Mm^Xm       , Mm^Xm       , Mm          , Mm          , Hh          , Gs^Fds      , Gs^Fms      
Hh^Fp       , Hh^Fp       , Gs^Fp       , Gs^Fp       , Hh^Fp       , Mm          , Mm          , Mm^Xm       , Mm^Xm       , Mm          , Mm          , Hh          , Hh          , Hh          , Mm          , Mm          , Mm          , Hh          , Gg          , Rp          , Rr          , Gg          , Gg          , Gg          , Gg          , Gg          , Hh          , Mm          , Mm^Xm       , Mm^Xm       , Mm          , Mm          , Hh          , Gs^Fms      , Gs^Fms      
Hh^Fp       , Hh^Fp       , Gs^Fp       , Gs^Vht      , Re^Gvs      , Hh^Fp       , Mm          , Mm          , Mm          , Mm^Xm       , Mm          , Mm          , Hh          , Hh          , Mm          , Mm          , Mm          , Hh          , Gg          , Gg          , Rp          , Gg          , Gg          , Gg          , Gg          , Gg          , Hh          , Mm          , Mm^Xm       , Mm^Xm       , Mm          , Hh          , Hh          , Gs^Fms      , Gs^Fms      
Hh^Fp       , Gs^Fp       , Gs^Fp       , Re^Gvs      , Re^Gvs      , Hh^Fp       , Hh^Fp       , Mm          , Mm          , Mm          , Hh^Fp       , Hh^Fp       , Gg          , Hh          , Hh          , Mm          , Hh          , Hh          , Gg          , Gg          , Gg          , Gg          , Gg          , Gg          , Gg          , Gg          , Hh          , Mm          , Mm          , Mm^Xm       , Mm          , Mm          , Hh          , Gs^Fms      , Gs^Fds      
Hh^Fp       , Gs^Fp       , Gs^Fp       , Gs^Fp       , Gg          , Gg          , Gg          , Hh^Fp       , Mm          , Mm          , Hh^Fp       , Gg          , Gg          , Gg          , Gg          , Hh          , Gg          , Gg          , Gg          , Gg          , Gg          , Rp          , Gg          , Gg          , Gg          , Gg          , Hh          , Hh          , Mm          , Mm^Xm       , Hh          , Hh          , Hh          , Gs^Fms      , Gs^Fms      
Hh^Fp       , Hh^Fp       , Hh^Fp       , Gs^Fp       , Gg          , Gg          , Gg          , Hh^Fp       , Mm          , Hh^Fp       , Hh^Fp       , Gg          , Hh^Fp       , Gg          , Hh          , Gg          , Gg          , Gg          , Gg          , Gg          , Gg          , Rr          , Gg          , Gg          , Re^Gvs      , Re^Gvs      , Re^Gvs      , Hh          , Mm          , Mm          , Hh          , Hh          , Mm          , Hh          , Hh          
Mm          , Hh^Fp       , Hh^Fp       , Gs^Fp       , Gg          , Gg          , Hh          , Hh^Fp       , Hh          , Mm          , Hh^Fp       , Gg          , Hh^Fp       , Hh^Fp       , Mm          , Hh          , Hh          , Gg          , Gg          , Gg          , Gg          , Gg          , Gg          , Gg          , Re^Gvs      , Gg^Vc       , Re^Gvs      , Hh          , Hh          , Hh          , Hh          , Hh          , Hh          , Hh          , Gg          
Mm          , Hh^Fp       , Hh^Fp       , Gs^Fp       , Gg          , Gg          , Hh          , Hh          , Mm          , Hh          , Gg          , Gg          , Hh^Fp       , Mm          , Mm          , Mm          , Mm          , Hh          , Gg          , Gg          , Rr          , Gg          , Gg          , Gg          , Hh          , Re^Gvs      , Hh          , Hh          , Hh          , Mm          , Hh          , Hh          , Gg          , Gg          , Gg          
Hh^Fp       , Hh^Fp       , Gs^Fp       , Gs^Fp       , Gg          , Gg          , Hh          , Hh          , Hh^Fp       , Hh^Fp       , Hh          , Gg          , Hh^Fp       , Hh^Fp       , Mm          , Mm          , Mm          , Hh          , Gg          , Gg          , Rr          , Gg          , Gg          , Gg          , Hh          , Hh          , Mm          , Mm          , Mm          , Hh          , Hh^Fp       , Gg          , Gg          , Gg          , Gg          
Hh^Fp       , Hh^Fp       , Gs^Fp       , Gg          , Re^Gvs      , Gg          , Gg          , Hh          , Hh^Fp       , Hh          , Hh          , Hh^Fp       , Hh^Fp       , Hh^Fp       , Hh          , Mm          , Hh          , Hh          , Gg          , Gg          , Rp          , Gg          , Gg          , Gg          , Hh          , Mm          , Hh          , Mm          , Mm          , Hh          , Gg          , Gg          , Gg          , Gg          , Gg          
Hh^Fp       , Hh^Fp       , Gs^Fp       , Gg          , Re^Gvs      , Gg^Vc       , Re^Gvs      , Gg          , Hh          , Hh          , Mm          , Hh          , Hh          , Hh          , Hh          , Hh          , Gg          , Gg          , Re^Gvs      , Gg          , Gg          , Gg          , Gg          , Gg          , Gg          , Hh          , Hh          , Hh          , Hh          , Hh          , Gg          , Gg          , Gg          , Gg          , Gg          
Hh^Fp       , Hh^Fp       , Hh^Fp       , Gs^Fp       , Gg          , Re^Gvs      , Gg          , Gg          , Hh          , Hh          , Hh          , Hh          , Hh^Fp       , Hh          , Hh          , Hh          , Gg          , Gg^Vc       , Re^Gvs      , Gg          , Gg          , Gg          , Gg          , Gg          , Hh          , Hh          , Mm          , Hh          , Hh          , Hh          , Hh          , Gg          , Gg          , Gg          , Gg          
Mm          , Mm          , Hh^Fp       , Hh^Fp       , Gg          , Gg          , Gg          , Hh          , Mm          , Hh          , Hh          , Gg          , Hh^Fp       , Hh          , Mm          , Hh          , Hh          , Gg          , Gg          , Gg          , Gg          , Ggf         , Gg          , Gg          , Gg          , Hh          , Hh^Fp       , Hh          , Hh          , Mm          , Hh          , Hh          , Gg          , Gg          , Gg          
Mm          , Mm          , Hh^Fp       , Hh^Fp       , Gg          , Gg          , Gg          , Hh          , Hh          , Hh          , Gg          , Gg          , Gg          , Hh          , Hh          , Hh          , Gg          , Gg          , Gg          , Gg          , Gg          , Ggf         , Gg          , Gg          , Gg          , Gg          , Gg          , Gg          , Gg          , Hh          , Gg          , Gg          , Gg          , Gg          , Gg          
Hh^Fp       , Mm          , Hh^Fp       , Hh^Fp       , Gs^Fp       , Gg          , Gg          , Gg          , Gg          , Gg          , Gg          , Ggf         , Hh          , Hh          , Gg          , Gg          , Gg          , Gg          , Gg          , Gg          , Gg          , Rp          , Gg          , Gg          , Gg          , Gg          , Gg          , Gg          , Gg          , Gg          , Gg          , Gg          , Gg          , Gg          , Gg          
Hh^Fp       , Hh^Fp       , Gs^Fp       , Gs^Fp       , Gs^Fp       , Gg          , Gg          , Gg          , Gg          , Gg          , Gg          , Gg          , Hh          , Hh          , Gg          , Gg          , Gg^Vc       , Gg          , Gg          , Gg          , Gg          , Rp          , Gg          , Gg          , Re^Gvs      , Gg          , Gg          , Gg          , Gg          , Gg          , Gg          , Gg          , Ce          , Gg          , Gg          
Hh^Fp       , Gs^Fp       , Gs^Fp       , Gs^Fp       , Gs^Fp       , Hh^Fp       , Hh^Fp       , Gg          , Gg          , Ggf         , Gg          , Gg          , Hh          , Mm          , Gg          , Gg          , Re^Gvs      , Re          , Gg          , Gg          , Gg          , Gg          , Gg          , Gg          , Re^Gvs      , Re^Gvs      , Gs^Fp       , Gg          , Gg          , Gg          , Gg          , Ce          , 2 Ke        , Ce          , Gg          
Mm          , Gs^Fp       , Gg          , Gs^Fp       , Gs^Fp       , Hh^Fp       , Hh^Fp       , Hh^Fp       , Gs^Fp       , Gg          , Gg          , Gg          , Hh          , Mm          , Mm          , Gg          , Gg          , Re^Gvs      , Gg          , Gg          , Rp          , Gg          , Gg          , Gg          , Re^Gvs      , Gg^Vc       , Gs^Fp       , Gg          , Gg          , Gg          , Gg          , Ce          , Ce          , Ce          , Gg          
Mm          , Mm          , Mm          , Gs^Fp       , Gs^Fp       , Hh^Fp       , Hh^Fp       , Hh^Fp       , Gs^Fp       , Gg          , Gg          , Gg          , Gg          , Hh          , Mm          , Gg          , Gg          , Gg          , Gg          , Gg          , Rp          , Gg          , Ggf         , Gg          , Gg          , Re^Gvs      , Gg          , Gg          , Gg          , Gg          , Gg          , Gg          , Gg          , Gg          , Gg          
Mm          , Mm          , Mm          , Mm          , Mm          , Gs^Fp       , Gs^Fp       , Gs^Fp       , Gg          , Gg          , Ggf         , Gg          , Gg          , Hh          , Hh          , Mm          , Gg          , Gg          , Ggf         , Gg          , Gg          , Gg          , Gg          , Gg          , Gg          , Gg          , Gg          , Gg          , Gs^Fds      , Gg          , Gg          , Gg          , Gg          , Gg          , Gg          
Mm^Xm       , Mm          , Mm          , Mm          , Mm          , Mm          , Mm          , Gg          , Gg          , Gg          , Gg          , Gg          , Gg          , Gg          , Hh          , Hh          , Gg          , Gg          , Gg          , Gg          , Gg          , Ggf         , Gg          , Gg          , Gg          , Gg          , Gg          , Gs^Fds      , Gs^Fds      , Gs^Fds      , Gg          , Gg          , Gg          , Gg          , Gg          
Mm^Xm       , Mm^Xm       , Mm^Xm       , Mm          , Mm          , Mm          , Mm          , Mm          , Gg^Vc       , Re^Gvs      , Re^Gvs      , Gg          , Gg          , Gg          , Hh          , Mm          , Mm          , Gg          , Gg          , Gg          , Gg          , Rp          , Gg          , Gg          , Gg          , Gg          , Ggf         , Ggf         , Gs^Fds      , Gs^Fds      , Gg          , Gg          , Gg          , Gg          , Gg          
Mm^Xm       , Mm^Xm       , Mm^Xm       , Mm^Xm       , Mm^Xm       , Mm          , Mm          , Mm          , Re^Gvs      , Re^Gvs      , Gg          , Gg          , Gg          , Gg          , Hh          , Mm          , Mm          , Mm          , Gg          , Gg          , Gg          , Rp          , Gg          , Gg          , Gg          , Ggf         , Ggf         , Ggf         , Ggf         , Ggf         , Gg          , Gg          , Gg          , Gg          , Gg          
Mm^Xm       , Mm^Xm       , Mm^Xm       , Mm^Xm       , Mm^Xm       , Mm^Xm       , Mm          , Gg          , Gg          , Gg          , Gg          , Gg          , Gg          , Gg          , Hh          , Mm          , Mm          , Mm          , Gg          , Gg          , Gg          , Re          , Gg          , Gg          , Gg          , Gg          , Ggf         , Ggf         , Hh          , Hh          , Hh          , Gg          , Gg          , Gg          , Gg          
Mm^Xm       , Mm^Xm       , Mm^Xm       , Mm^Xm       , Mm^Xm       , Mm^Xm       , Mm          , Gg          , Gg          , Gg          , Gg          , Gg          , Gg          , Gg          , Gg          , Hh          , Hh          , Mm          , Hh          , Gg          , Gg          , Re          , Gg          , Gg          , Gg          , Gg          , Gg          , Hh          , Mm          , Mm          , Hh          , Gg          , Gg          , Gg          , Gg          
Mm^Xm       , Mm^Xm       , Mm^Xm       , Mm^Xm       , Mm^Xm       , Mm^Xm       , Mm          , Gg          , Gg          , Gg          , Gg          , Gg          , Gg          , Gg          , Gg          , Gg          , Gg          , Hh          , Gg          , Gg          , Rp          , Rp          , Gg          , Gg          , Gg          , Gg          , Gg          , Hh          , Mm          , Mm          , Hh^Fp       , Gg          , Gg          , Gg          , Gg          
Mm^Xm       , Mm^Xm       , Mm^Xm       , Mm^Xm       , Mm^Xm       , Mm^Xm       , Mm          , Gg          , Gg          , Mm          , Gg          , Gg          , Gg          , Gg          , Gg          , Gg          , Gg          , Gg          , Gg          , Gg          , Re          , Re          , Gg          , Gg          , Gg          , Gg          , Gg          , Hh          , Hh          , Mm          , Hh^Fp       , Gg          , Gg          , Gg          , Gg          
Mm^Xm       , Mm^Xm       , Mm^Xm       , Mm^Xm       , Mm          , Mm          , Mm          , Gg          , Mm          , Mm          , Gg          , Gg          , Gg          , Gg          , Gg          , Gg          , Gg          , Gg          , Gg          , Gg          , Re          , Gg          , Gg          , Gg          , Hh          , Hh          , Hh          , Hh          , Hh          , Hh          , Gg          , Gg          , Gg          , Gg          , Gg          
Mm^Xm       , Mm^Xm       , Mm^Xm       , Mm^Xm       , Mm          , Mm          , Mm          , Mm          , Gg          , Gg          , Gg          , Gg          , Gg          , Gg          , Gg          , Gg          , Ce          , Ce          , Rp          , Re          , Gg          , Gg          , Gg          , Hh          , Mm          , Mm          , Mm          , Hh          , Gg          , Gg          , Gg          , Gg          , Gg          , Gg          , Gg          
Mm          , Mm^Xm       , Mm          , Mm          , Mm          , Mm          , Mm          , Mm          , Gg          , Gg          , Gg          , Gg          , Gg          , Gg          , Gg          , Gg          , Ce          , 3 Ke        , Rp          , Gg          , Gg          , Ggf         , Gg          , Hh          , Hh          , Mm          , Hh^Fp       , Hh^Fp       , Gg          , Gg          , Gs^Fp       , Gg          , Gg          , Gg          , Gg          
Mm          , Mm          , Mm          , Mm          , Mm          , Mm          , Mm          , Gg          , Gg          , Gg          , Gg          , Gg          , Gg          , Gg          , Gg          , Re^Vct      , Gg          , Ce          , Rp          , Gg          , Gg          , Gg          , Gg          , Gg          , Gg          , Hh          , Gg          , Gg          , Gg          , Gg          , Gg          , Gg          , Gg          , Gg          , Gg          
Mm          , Mm          , Mm          , Mm          , Mm          , Mm          , Mm          , Mm          , Gg          , Gg          , Gg          , Gg          , Gg          , Gg          , Gg          , Gg          , Gg          , Gg          , Rp          , Gg          , Gg          , Gg          , Gg          , Gg          , Gg          , Gg          , Gg          , Gg          , Gg          , Gg          , Gg          , Gg          , Gg          , Gg          , Gg          
